0000000000000000000000000000
0000000000000000000000000000
0000000000000000000000000000
0000000000000000000000000003
1000000000000020000000000003
1003330033330020033330033303
1000020000020020000020000203
1011120111120120111120111203
1000000000000000000000000003
1003330030033333330030033303
1011120020111121120020111203
1000000020000020000020000003
1222230033330020033020022222
0000010021120120111120300000
0000010020000000000020300000
0000010020310000120020300000
0000020120200000000120100000
0000000000200000000000000000
2222230030200000000030022222
0000010020033333310020300000
0000010020000000000020300000
0000010020033333330020300000
0000020120111121120120100003
1000000000000020000000000003
1003330033330020033330033303
1011120111120120111120021203
1000020000000000000000020003
1330020030033333330030020033
1120120020111121120020120113
1000000020000020000020000003
1003333033330020033033333303
1011111111120120111111111203
1000000000000000000000000003
1222222222222222222222222222
0000000000000000000000000000
0000000000000000000000000000